block grant	federal grants that are given almost automatically to states and/or communities to support broad programs in areas
categorical grants	Federal grants that can be used only for specific purposes or "categories," of state and local spending. They come with strings attached, such as nondiscrimination provisions. Compare to block grants.
Centralists	People who favor national action over action at the state and local levels
commerce clause	The clause in the Constitution (Article I, Section 8, Clause 1) that gives Congress the power to regulate all business activities that cross state lines or affect more than one state or other nations.
concurrent powers	Powers that the Constitution gives to both the national and state governments, such as the power to levy taxes.
Conditions of aid	Federal rules attached to the grants that states receive. States must agree to abide by these rules in order to receive the grants.
Confederation	A system in which states are soveriegn and the national goverment may only do what states permit
Cooperative Federalism	cooperation among federal, state, and local giverments (marble cake)
decentralization	the spread of power away from the center to local branches or governments
deconcentration	administrative decentralization
>involves transfer of functions from the national office to the regional and local offices
>delegating functions from the central government to local government units (sectoral approach)
>redistribution of administrative responsibilities
Devolution	the process of shifting some power from national to local government
dillon's rule	a rule that limits the powers of local gov't to those expressly granted by the state or those powers closely linked to the express powers
Dual Federalism	doctrine that the state & national governments are supreme in their separate spheres
Elastic Clause	Article 1, section 8, allows congress to pass all necessary and proper laws to carry out enumerated powers.
Enumerated powers	powers of the fed government specifically addressed in the constitution, powers listed in article one section 8
Express powers	Those delegated powers of the National Government that are given to it in so many words by the constitution
Extradition	legal process where alleged criminal is surrendered by officials of one state to that of another in which the alleged crime was committed
Federal Mandate	A federal law or act compelling State to take certain actions sometimes without providing funding
Federalism	a way of organizing a nation so that two or more levels of government have authority
Fiscal Federalism	pattern of spending, taxing, and providing grants in federal system; cornerstone of national government's relationship with state and local governments
Formula Grants	federal categorical grants given according to a formula specified in legislation or regulations
Full Faith & Credit Clause	Article 4, section 1 ; requires each state to recognize official documents & civil judgments rendered by the courts of other states
Gibbons v. Ogden	1824, landmark case in which the Supreme court interpreting Article 1 section 8 of the constitution very broadly giving congress the power to regulate interstate commerce, encompassing almost every form of commercial activity
Grants-in-aid	Money given by the national government to the states, were originally used to finance universities as well as to build wagon roads, canals, railroads, and flood-control projects
Implied Powers	- powers of federal government that goes beyond those stated in the constitution; an example of this is creation of institutions not foreseen directly in the Constitution such as a national bank
Inherent powers	The powers of the national government in foreign affairs that the Supreme Court has declared do not depend on constitutional grants but rather grow out of the very existence of the national government
Intergovernmental Relations	The workings of the federal system- the entire set of interactions among national, state, and local governments
Interstate Compact	An agreement among two or more states, congress must approve most such agreements
McCulloch v. Maryland	attempt by Maryland to destroy a branch of the bank of the US by imposing a tax on its notes, most famous Marshall Decision, No national bank, upheld bank rights to exist and be free from taxes
National Supremacy	Constitutional doctrine that whenever conflict occurs between the constitutionally authorized actions of the national government and those of a state or local government, the actions of the federal government prevail
Necessary & Proper Clause	Constitutional clause that gives congress the power to make all laws "necessary and proper" for executing its powers
Nullification	the states'-rights doctrine that a state can refuse to recognize or to enforce a federal law passed by the United States Congress
Preemption	The right to purchase something before others, especially the right to purchase public land that is granted to one who has settled on that land
Privileges & Immunities	guarantees that "citizens of each state shall be entitled to all privileges and immunities of citizens" in any other state in the United States
Revenue Sharing	Distribution of a portion of federal tax revenues to state and municipal governments
Second-order Devolution	A flow of power and responsibility form the states to local governments
Sovereignty	Supremacy of authority or rule as exercised by a sovereign or sovereign state
States' rights	All rights not delegated to the federal government by the Constitution nor denied by it to the states
Supremacy Clause	The clause of Article VI section 2 of the U.S. Constitution that declares that all laws and treaties made by the federal government shall be the "supreme law of the land."
Tenth Amendment	Last amendment in the Bill of Rights that states that any powers not given to the national government will be given to the individual states
Third-order Devolution	- Increased role of non-profit organizations and private groups in policy implementation
Unitary Government	a centralized government in which all government powers belong to a single central agency