abandon	a feeling of intense freedom after removing restraint
abate	to lessen in intensity
abdicate	to surrender a role of responsibility (referred to a transfer of power)
aberrant	departing from an accepted standard
abet	to help someone do something illegal
abhor	to dislike something very much (usually because you think its immoral)
abject	extreme or severe
abominate	to loathe and despise it
abortive	unsuccessful, cut short without finishing it
abscond	to run away
absolve	to publicly and formally remove any blame for a given deed
abstruse	complex and difficult to understand
abysmal	terrible, extremely bad, wretched
acclimate	to make it suitable for you, adapt, get used to something
accost	to move towards someone and speak in a threatening, unpleasant way and demand attention and time
accrue	to become greater in size gradually
acquiesce	to allow someones actions or opinions to proceed despite any doubts
acrid	strong and bitter, stings your nose/throat
acuity	clear and insightful thinking
addendum	an additional section added to the end of a book/document/speech
adjudicate	to officially decide the outcome of a conflict/argument
adulation	excessive praise and admiration for someone, flattery
affable	friendly, easy to talk to
agnostic	a person who believes that it is impossible to know conclusively whether God exists or not (doubtful about other things as well)
agrarian	related to agriculture/farming
alienate	to isolate from a society or group
allay	to make less intense
allude	to refer to something in an indirect way
altruistic	care more for other people than yourself
amalgamate	to join them together to form a new whole
amatory	one of physical love
ambient	part of or in the surrounding environment
ambivalent	uncertain whether you like something or not/what you should do about something
ambulatory	capable of walking
amity	peaceful friendship between to parties (two countries)
anachronism	out of place because it is set in the wrong time period
analogous	enough similarities exist to form a comparison
ancillary	providing additional support
anomaly	a trait that is different from what is expected so it is highly noticeable
apparition	something that unexpectedly appears (ghost or ghostly)
approbation	an act of official praise and approval
arcane	mysterious and secret
archetype	an original source or form of something commonly experienced
archipelago	a cluster of islands
arduous	extremely difficult, involves a lot of effort
assay	to analyze the chemicals present in a substance, put something to the test
attrition	employees are lost over a period of time. gradually decreasing the strength of someone by continually attacking it
auspices	being guided and protected by someone (to be under someones ___)
autocratic	rules with complete power
awry	does not go in the way you planned
axiom	a widely recognized general truth that is often self-evident
baroque	overly decorated, showy, excessive
bastion	something that defends the existence of an idea or way of life
bedeck	to decorate in a showy way
bedevil	causing a lot of problems over a period of time
bedlam	a situation full of noise and confusion
beget	to cause something to happen or exist
beguile	to charm, entrance, or fool
behest	command or urgent request
beholden	feeling like you are in someones debt/have a duty towards them because they have helped you in some way
bellicose	to be prone to physically fight with someone
bemused	to be baffled or confused
benefaction	a charitable contribution of money or assistance that someone gives to a person or an organization
berate	to scold harshly
bourgeois	people from the upper middle class and are traditional, conservative and materialistic
brazen	not embarrassed by anything he/she does. does not care what other people think of him
bristling	to respond in an offended and annoyed manner
broach	to bring up a delicate topic in order to discuss it
buoyant	in good spirits, lifted, happy
cadre	a group specially trained to do something
cajole	to persuade someone by being overly flattering
camaraderie	a feeling of friendship or trust among a group of people who have known each other for a long period of time
candor	the quality of being honest and open in speech or action
capricious	changes his mind easily, behaves in an unpredictable way
cardinal	basic, essential, important
carnage	a mass of dead bodies, slaughter, massacre
caustic	biting, unkind, critical, mocking, cruel
cavalier	unmoved by serious events, rules or people, conceited/arrogant
cede	to hand over under pressure
censure	verbal disapproval, harsh criticism of something
cessation	a stop or interruption in an activity
chaff	unusable part of the grain that is cast aside, useless part
chagrin	embarrassed because you have failed something or have been let down in some way
chastise	to be scolded angrily
chivalrous	behaving in a polite, kind, and honorable way, especiallly to women
circuitous	indirect and complicated
circumscribe	to contain, limit, put a border around something
clandestine	hidden, kept a secret
clarion	a stirring, emotional and strong appeal to people to take action in something
clemency	showing mercy and forgiveness by reducing a punishment
cloister	to remove and isolate
coalesce	combine together to form a single larger unit
cogent	influential and significant
commune	to connect directly without using words
compendium	a collection of information on a particular subject
concerted	work that is performed by two or more people
confluence	a situation where two or more things meet or flow together at a single point (two streams joining together)
congenital	something someone is born with
connive	secretly plan to achieve something (usually something illegal or immoral)
connote	to refer to a secondary reference or meaning
consign	to give it to another person's watchful care
consternation	helpless anxiety and fear
consummate	complete and supreme ability for something
contagion	the transmission of the disease that spreads easily or the bacteria or virus that causes the illness
contiguous	in contact with/ near each other. ___ events happen in a connected, uninterrupted way
contravene	to do something that is not allowed/forbidden by the law or agreement
convalescent	a time of getting better after medical trauma
convoluted	complicated and too involved/twisted
corporeal	relating to the physical/material world rather than the spiritual world. characteristics of the body rather than the mind or feelings
corroborate	to give information or evidence that further supports something
covet	to really want something that belongs to somebody else
craven	very cowardly
credence	to believe in its certainty
crestfallen	depressed, sad, brokenhearted
crux	the most important/difficult part of something, which affects everything else
cull	to gather from many sources
culminate	to reach its highest point or climax
curative	helps to heal ailments. has curing powers
curio	an object which is very old or unusual
cursory	very quick and incomplete. does not pay close attention to detail
dapper	has a very neat and clean apperance
daunt	to make you alarmed or worried
dearth	a scarcity or lack of something
debacle	a failed and embarrassing attempt at something
debunk	to disprove something
decry	to speak against something, find fault within it
defile	to harm it so that what was sacred is now polluted
deft	able and quick, with skill
degenerate	immoral, wicked, corrupt
delectable	delicious and very pleasant
deliberate	to think about or discuss something very carefully
delusive	deceiving by giving you false information
demeanor	the way you look and behave which gives people insight to your character in feelings
demure	quiet, shy, always behaving modestly
denigrate	to blacken something/someones reputation or character
deportment	the way you behave or carry yourself in public
deprecate	to critisize someone/something strongly
derelict	property that is falling apart or in great disrepair
derision	mocking, making fun of something
despondent	in very low spirits
despot	a leader who uses power in a cruel way
diabolical	very bad, evil, cruel
dictum	a saying that people often repeat because it is interesting or wise
digress	to temporary stray from the central point of the conversation
disconcert	makes you feel anxious, worried or confused
discordant	does not fit will other things. disagreeable, strange, unpleasant
disparate	very unlike each other
disparity	not of equal status, different, unlike
disposed	to be inclined/partial towards something. likely to accept it
dissolution	an official end
dissonance	disagreement. ideas/actions are not in agreement. a harsh combination of sounds
diurnal	happening on a daily basis
divest	to strip it away entirely, take away
divulge	to reveal information that was once private or secret
docile	gentle, calm and well-behaved
dogmatic	assertive and overly self-important. must be accepted with no questions asked
domicile	the place where you live, your home
ebullient	full of enthusiasm and excitement
echelon	a level of status or rank in an organization
ecumenical	purposely combines different Christian traditions
effigy	poorly made image of someone usually disliked
elocution	the skillful and effective way one speaks in public
elucidate	to make something clear by explaining it in detail
embellish	to make it more beautiful by decorating it
emissary	someone who acts as a representative of one government or leader to another
empirical	based on real experience/ scientific experiment
enclave	a small area within a larger area of a city or a country in which people of a different nationality or a culture live
encroachment	violating another person's rights. intruding another person's private space
encumber	to make difficult to move freely
endemic	frequently found and restricted to that region. very common, strong, cannot be wiped out
engender	causing something to happen
enigmatic	mysterious and difficult to understand
entourage	a group of assistants, servants, or people who tag around someone important
enunciate	to speak or state something clearly so that you can be easily understood
envisage	to imagine or consider somethings future possibility
ephemeral	lasting for only a short time
eschew	to deliberately avoid doing something for moral reasons
espouse	to defend it, support it
ethereal	has a delicate beauty that makes it seem not like a part of the real world
eulogy	a speech often part of a funeral in which you praise someone or something very much
evocation	creates a clear mental image through words, pictures, or music
exacting	expects other people to work very hard and carefully
exalt	to praise highly or promote someone to a higher position in an organization
exonerate	to officially excuse that person for any responsibility for a wrong
expatriate	someone who no longer lives in his native country
expound	to explain something in great detail
extraneous	not relevant or connected to something else, not essential
extricate	to clear yourself from something unpleasant
exude	to flow from someone/something
exult	to show great pleasure or excitement
facile	shallow, easy, simplistic and on the surface
farce	very badly organised, unsuccessful, silly, ridiculous
felicity	happiness and blissfulness
fester	to grow worse
fiat	an official order from a person or group in authority
fiduciary	involving trust and managing money or amounts of property
filial	describing relationships between children and their parents
finesse	showing great skill and care
fledgling	has just begun
flippant	disrespectful, not taking something as serious as it should be
foible	a small weakness and character flaw in someone which is viewed as strange but harmless
forte	personal strength or expertise
fortitude	the determination, lasting courage to endure hardship or difficulty over an extended period of time
fracas	a rough and noisy fight that can involve multiple people
fruition	fully realized and achieved
fugue	a musical form that repeats a single theme
furtive	secretly, sneakily
gargantuan	extremely large
garish	bright and colorful in an ugly, cheap and showy way. tacky
gentry	the elite, nobility, upperclass members of a society
gilded	covered or decorated to make it look better
glib	makes something sound simple, easy and problem-free when it really wasn't
gradation	small, gradual steps/changes over time
gratuitous	unmerited and not essential. can be harmful or upsetting
gubernatorial	pertaining to a governor
harbinger	a sign that foretells that something is going to happen
heinous	evil, horrifying, shocking, bad
hiatus	a period of time when there is a break or interruption of some activity
hindsight	the looking back upon of an event to see what should have been done instead of what was done
humdrum	boring, dull or tiresome
hyperbole	an exaggerated statement
idiosyncratic	odd, unusual, strange
idolatry	the practice of admiring someone too much
imbibe	to take in fully, absorb. drinking water/beverages
imbue	to fill something/someone completely with something
immutable	cannot be changed
impasse	a difficult situation in which progress is not possible, progress is stalled
impassive	not showing any emotion
imperceptible	impossible/difficult to be perceived by the mind
impertinent	behaving rudely and disrespectfully to a superior, such as an older person
impinge	intrudes upon, invades it. affects in some negative way
implacable	very angry, strong hostile feelings which will not change
impregnable	very difficult to change, overcome
impudence	behaving in a very rude or disrespectful way
impunity	getting away with something you shouldn't do
impute	to attribute something to someone
inadvertent	not intentional
inalienable	cannot be taken away
inane	silly and meaningless
incendiary	something that stirs things up or lights things on fire
inception	beginning or start
incipient	just beginning to develop
incisive	expressed clearly and briefly, and demonstrates real understanding of related issues
incommunicado	unable to be communicated with, in an isolated situation
inconsolable	so devastated that nobody can help them feel better about it. cannot be consoled
inconspicuous	does not attract attention, not easily noticed or seen
incorrigible	attitudes and actions that repeatedly break the rules. unable to be corrected (?)
incursion	sudden hostile attack, unpleasant intrusion
indiscreet	shows lack of judgement, foolish, hasty
indomitable	cannot be beaten, refuses to give up
indulgent	let people have what they want
infinitesimal	immeasurably small
inflection	a change or variation in a persons voice, or in the form a noun or verb takes
inimical	unfriendly and will likely cause you harm
inimitable	so good/unique that nobody else can be equal
iniquity	an immoral act, great injustice
innocuous	not likely to offend or harm anyone
inopportune	untimely and troublesome. inconvenient. not suitable
inscrutable	very hard to figure out, discover, understand
insidious	dangerous because it seems harmless at first but gradually develops over time to cause hurt and damage
insipid	boring, without interest, dull
insular	unwilling to meet anyone, uninterested in learning new ideas
intelligentsia	the most highly educated members of society
interject	to insert a comment during a conversation that interrupts its flow
intersperse	to scatter or distribute things among others
intractable	very difficult, impossible to deal with
intrepid	willing to do dangerous things, bold, brave
introspective	when one examines her thoughts and feelings often
irreconcilable	so opposite to each other that it is impossible to agree/reach a settlement
itinerant	moving around from place to place
juggernaut	a very powerful force or organization whose influence cannot be stopped
lamentable	sad or distressing
languid	relaxed, slow, lazy
lexicon	the collective words and phrases of a language
limber	flexible in both body and mind
lithe	moving with suppleness, grace and ease
litigate	to go to a court in order to bring forth a lawsuit or voice another concern you may have
liturgy	the set of rules or formal procedures used during church services
livid	extremely angry
loquacious	talks too much
malady	a serious illness. a serious or widespread problem within a society/organization
malign	to say unpleasant things about something to damage his reputation
malleable	easily influenced, controlled
matriarch	a powerful woman who controls a community, family or other social group
maverick	strong-willed, thinks for herself
maxim	a recognized rule, general statement of a truth or principle
meritorious	worthy of receiving recognition because of what he has accomplished
mesmerize	to attract or hold your interest, to captivate
meteoric	run through very quickly
microcosm	a miniature copy of a larger thing
milieu	things and people that surround you and influence the way in which you behave
minuscule	very tiny in size
misapprehension	a wrong idea about something or someone
misconstrue	to interpret wrongly
misnomer	an unsuitable or misleading term
mitigate	to reduce the harmful/painful affects of something
mollify	to say or do something to make someone feel less angry or upset
monastic	very simple, living in a self-denying way
monolith	an organization or system that is very large and slow to change in any way
morose	unhappy, bad tempered, unwilling to talk a lot
myriad	a huge number of something in a great variety
nebulous	unclear, undefined
nemesis	opponent or rival who cannot be beaten, causes your downfall
nettle	to irritate
nomenclature	a specialised form of vocabulary to classify living organisms into a clear system
nonchalant	unconcerned, calm, relaxed
notional	only an idea, theory not a reality
nuance	a small difference in something that is difficult to notice by fairly important
obsolescent	used less and less, becoming no longer needed
obtuse	slow to understand things, deliberately does not try to figure things out
obviate	to eliminate something to make solving the problem unnecessary. to see it coming and to avoid it
odious	unpleasant or horrible
onerous	making you dislike doing something because it is difficult or tiring
opine	to speak out your thoughts
opulent	exhibits great wealth
oscillate	to move repeatedly from one point to another and back
ostentatious	extreme exaggerated way of impressing people, flashy
overt	not hidden or secret
palatable	delightful and acceptable
palatial	like a palace. grand, impressive
pallid	unhealthily white, very pale
palpable	so strong that it is easily noticed and almost able to be physically felt
pandemic	sweeping and unlimited
pander	to cater or suck up to someone in order to influence or exploit her in some way
paragon	example of a thing or person at its or her very best
parenthetical	additional information
parry	to dodge or resist, ward something off, deflect
pastoral	peaceful, rural, natural
pathogen	an organism that causes disease
pathological	uncontrolled, extreme, unreasonable in something that you do
pecuniary	relating to or concerning money
pedagogy	the methods used by a teacher to teach a subject
penchant	a deep attachment for something, fondness
pernicious	causes great harm, evil
personify	to be the perfect example of something
peruse	to look through something with great detail
petulant	behaving in an unreasonable and childish way
pillage	to steal and damage property in war
pique	moved or grabbed by something
pithy	to the point, precise, brief
pittance	an insufficient amount of something
plethora	too much of something
plummet	tumble and drop with great speed
polarization	a separation caused by a conflicting opinion or difference in views
ponderous	boring, highly serious, seems very long and wordy
potable	safe to drink
prattle	mindless chatter that seems like it will never stop
precept	an instruction or rule that teaches correct behavior
precipitous	very steep, falls sharply
precocious	showing intelligence or skill at an unusually young age
preponderance	a great amount
prerogative	the right or privilege to do something
presumptuous	acting in a disrespectful, pushy or unacceptable way
primordial	of the earliest times
profundity	great depth of understanding, depth or complexity of something
propagate	to create or grow more of something
propitious	favorable conditions
protege	a promising young person who has been taught by an older and more experienced person over time
prowess	skill or ability in something
punitive	intended to punish someone for something that person has done
quagmire	a difficult or complicated situation which is difficult to get out of
qualm	uneasiness or worries about something
quandary	a difficult situation where you have to make a decision but you dont know what to do
quaver	to shake or tremble with anxiety
quintessential	an ideal example of its type
rambunctious	wild, unruly, very active and hard to control
rancid	no longer fresh, decomposing, has a bad taste or smell
rebuff	to stop what is happening in a harsh way, reject
recant	to publicly announce that your own firmly held beliefs were wrong that that you no longer agree with them
recluse	someone who chooses to live alone and deliberately avoids other people
recompense	a payment or agreement to settle a loss
recoup	to get back the sum of money you originally spent
recrimination	an accusation you make against someone who accused you of something first
redress	to mend a harmful event by improving the situation.
relegate	to give a less important position than before
remission	the gradual going away of something
remuneration	compensation, money, award for work done, services rendered, goods provided
renege	to go back on your word
replete	have plenty of something
reprisal	revenge
repute	reputation/ what others think of him or her
requiem	a mass at a funeral, or a piece of music written for the dead
rescind	to officially repeal a law, agreement, statement
resilience	recover quickly from unpleasant events
retinue	the group of people who travel with someone important to help and support him/her
retrograde	it worsens or declines from its current state to a poorer state
retrospect	look back in the past with the advantage of knowing more now than you did then
revelry	a celebration with eating, dancing and drinking
reverberate	to echo or rebounds from one place to another
reverie	a state of having pleasant, deep thoughts that make you forget what is happening around you
revile	intensely hated and criticised
rife	common and seems to be everywhere
ruse	a clever trick or deception used to fool someone
salient	things that are the most important, noticeable, obvious
sanguine	cheerful, confident about a bad situation that everything will work out the way you want it to
sardonic	showing a lack of respect
saunter	to take a stroll or slow walk from one place to another
schism	a division or a split in a group as a result of differences in beliefs
scrupulous	takes great care to do everything in an honest and fair manner
sedition	open rebellion against a government
semblance	an outward appearance of what is wanted or expected but not exactly as hoped for
servile	too obedient, too agreeable, to willing to do anything for another person
shard	sharp pieces of glass, metal or other hard substances
skittish	nervous and easily alarmed
slovenly	untidy, messy
sojourn	to stay at a place that is not your home for a short amount of time
soliloquy	a theatrical speech voiced alone
sonorous	a sound that is full and rich
sordid	filthy or morally low
spate	a large quantity of something
spurious	based upon false evidence
squalor	very dirty, unpleasant conditions
squeamish	easily nauseated or shocked by things very easily, oversensitive
stasis	a state of little change over a long period of time
stolid	shows little emotion about anything
stricture	a rule that imposes restrictions/limits on what you can do
strident	forceful and loudly rude in verbal expression
stupor	a state in which the mind and senses are dull usually due to the use of alcohol or drugs
sublime	supremely beautiful that moves the heart
subservient	too eager and willing to do what other people want
succinct	to the point, brief
succulent	juicy, tasty. full of water and good to eat
sundry	randomly assembled, different from each other
supine	lying flat on your back
supplant	to replace someone with somebody else
surmount	to triumph, overcome something
surrogate	someone who temporarily takes the place of another person
sylvan	related to forests or trees
synchronous	when two things happen together
synergy	extra energy/additional effectiveness when two groups combine their efforts instead of working separately
tacit	understood without having to use words to express something, implied
tactile	something that can be physically touched
talisman	a symbol of good luck
tangential	merely touches its point, not at its core
tantalize	desirable and provoking but out of reach
taxonomy	the science of classifying plants and animals into an organised system
tempestuous	wild, violent and stormy
temporal	deals with the present and somewhat brief time of this world
tenet	a solid viewpoint held by a specific group
tenuous	weak and unconvincing, doubtful, thin
tepid	lukewarm, lacking in enthusiasm, mild
terse	abrupt and concise
timorous	to be fearful
tirade	a long critical speech filled with complaints
torrid	intensely hot, dry
torsion	the strain produced on a body by twisting it
tortuous	long and complicated with many twists and turns.
transfuse	to pass something along to something else
transmute	to change its form
travail	significant toil, suffering, and very difficult/unpleasant work
trepidation	fear or uneasiness about something that is going to happen
tribulation	suffering, difficulties experienced in a particular situation
trite	so overused, no longer interesting, unoriginal
truncate	to make something shorter/faster by cutting off part of it
tumultuous	filled with great excitement, confusion, violence. usually to do with large crowds
ulterior	hidden reason for doing something
ultimatum	the final statement on an issue
unassuming	not boastful, arrogant. modest
unbridled	enthusiastic and uncontrolled
uncouth	awkward and unmannerly
undulate	moves or is shaped like waves with gentle curves that smoothly rises and falls
unfounded	something with no evidence to support it. unproven, groundless
unkempt	untidy, messy
unnerve	makes you upset or nervous, or lose your courage because it frightens you
unobtrusive	not easily noticed, humble
unsavory	objectionable, unacceptable, unpleasant
unwitting	unintentional, you didn't know you were doing it
vacuous	empty or lacking in something
vantage	a position that has a benefit, advantageous
vaporous	cloudy and misty
variegated	characterized by various markings, various colors, etc. filled with variety
vassal	workers who served a lord in exchange for land in the middle ages
vendetta	a prolonged fight and feud between two groups
venerable	worthy of being given respect by those who admire him/her
verbiage	an excessive use of words used to convey something that could be expressed with fewer words. manner/style in which one uses words
verbose	excessively wordy
verity	truth or reality of something
vernacular	the ordinary and everyday language spoken by people in a particular country or region
vernal	the season of spring, youth/freshness
vicarious	experienced indirectly through others
vilify	to write or say bad things about someone to ruin their reputation
vindictive	wanting to take revenge on someone
virtuoso	someone who is very skilful at something (especially playing a musical instrument)
virulent	very dangerous, poisonous, hostile, spreading very quickly
volition	the act of doing something something out of your own free will
voluminous	large, long or vast in size
vortex	a force which draws things to its center and overwhelms anything caught within it
wallow	to absorb or immerse oneself in it. to be involved in a negative feeling
wanton	deliberately harms or damages something/someone for no apparent reason
wastrel	a lazy person who wastes time and money
whet	to increase or stimulate something
wistful	sadly wishing for something in the past to return
woebegone	gloomy, filled with grief
writ	an official document that orders a person to do something
